lovely (with Khalid) - lovely (with Khalid) by Billie Eilish
Falling - Fine Line by Harry Styles
when the party's over - WHEN WE ALL FALL ASLEEP, WHERE DO WE GO? by Billie Eilish
you broke me first - you broke me first by Tate McRae
All of Me - Love In The Future (Expanded Edition) by John Legend
Before You Go - Divinely Uninspired To A Hellish Extent (Extended Edition) by Lewis Capaldi
Africa - Toto IV by TOTO
Bruises - Divinely Uninspired To A Hellish Extent by Lewis Capaldi
Pumped Up Kicks - Torches by Foster The People
Surrender - Surrender by Natalie Taylor
Take on Me - Hunting High and Low by a-ha
Here Comes The Sun - Remastered 2009 - Abbey Road (Remastered) by The Beatles
Highway to Hell - Highway to Hell by AC/DC
Mr. Blue Sky - Out of the Blue by Electric Light Orchestra
No Time To Die - No Time To Die by Billie Eilish
Rocket Man (I Think It's Going To Be A Long, Long Time) - Honky Chateau by Elton John
Paradise - Mylo Xyloto by Coldplay
Chop Suey! - Toxicity by System Of A Down
Jealous - Jealous by Labrinth
Someone Like You - 21 by Adele
Dancing With Your Ghost - Dancing With Your Ghost by Sasha Sloan
Get Lucky (feat. Pharrell Williams & Nile Rodgers) - Radio Edit - Get Lucky (feat. Pharrell Williams & Nile Rodgers) [Radio Edit] by Daft Punk
Killing In The Name - Rage Against The Machine - XX (20th Anniversary Special Edition) by Rage Against The Machine
Little Talks - My Head Is An Animal by Of Monsters and Men
comethru - summer, by Jeremy Zucker
Crazy - St. Elsewhere by Gnarls Barkley
Dani California - Stadium Arcadium by Red Hot Chili Peppers
Listen to the Music - Toulouse Street by The Doobie Brothers
Mr. Jones - August And Everything After by Counting Crows
Somebody That I Used To Know - Making Mirrors by Gotye
