1999 - 1999 by Prince
99 Luftballons - 99 Luftballons by Nena
A Boy Brushed Red Living In Black And White - They're Only Chasing Safety by Underoath
A Little Less Conversation - JXL Radio Edit Remix - Elvis 75 - Good Rockin' Tonight by Elvis Presley
A Place for My Head - Hybrid Theory (Bonus Edition) by Linkin Park
ATTACK - A Beautiful Lie + 30 Seconds To Mars by Thirty Seconds To Mars
Adagio For Strings - Adagio For Strings by Lucas & Steve
Afraid of Heights - Afraid of Heights by Billy Talent
Africa - Toto IV by TOTO
Afterlife - Avenged Sevenfold by Avenged Sevenfold
Alive - Alive by Paris Blohm
All These Things I Hate (Revolve Around Me) - The Poison by Bullet For My Valentine
All in the Suit That You Wear - Thank You by Stone Temple Pilots
All or Nothing (feat. Axel Ehnström) - Deluxe Mix - Less is More (Deluxe) by Lost Frequencies
Always - Back Into Your System by Saliva
Angry Chair - The Essential Alice In Chains by Alice In Chains
Anthem - Anthem by EDX
Anthem of Our Dying Day - Page Avenue (US Non-PA Version) by Story Of The Year
Are You Gonna Be My Girl - Get Born by Jet
As I Sleep (feat. Charlee) - As I Sleep (feat. Charlee) by Tobtok
Away From Me - Life On Display by Puddle Of Mudd
Back Where I Belong (feat. Avicii) - Back Where I Belong (feat. Avicii) by Otto Knows
Bat Country - City of Evil by Avenged Sevenfold
Beautiful Life - Beautiful Life by Lost Frequencies
Beautiful Night - Burden Brothers EP by Burden Brothers
Bennie And The Jets - Remastered 2014 - Goodbye Yellow Brick Road (40th Anniversary Celebration/ Super Deluxe Edition) by Elton John
Better Together - In Between Dreams by Jack Johnson
Billinghurst - Damon EP by Jeremy Olander
Blackout - Blackout by (Hed) P.E.
Blame - Blame by Manse
